2 2 2 2 2 2
2 2 0 0 2 2
3 3 1 1 3 3
1 2 4 4 2 1
3 0 4 4 0 2
3 0 2 0 4 3